2222222222222222222222222
2000000303000011000000002
2020102222220011222021102
2000100020011011002021102
2211200020111020002022202
2000000020200020000000002
2222322333221220123232102
2010001020200020103030102
2011211020111020123232102
2022222020011010000000002
2023332020000010001111002
2001010011223222212222212
2322322320230320101020102
2000000020200010010020032
2222222222222222222222222